
F    255    , 255, 0 
NO ./Assets/pineapple_wall.xpm



WE ./Assets/castle_wall.xpm


C 255,255,255
SO ./Assets/snow_wall.xpm
EA ./Assets/grass_wall.xpm

111111111111111
1001000010000001
1001000010000001
1001112110011111
1000000000001
100000N0000001
1000000000001
1000000000001
1000010000001
1000010000001
111111111111