
F    40    , 30, 5 
NO ./Assets/so_longo.xpm


SO ./Assets/so_longo.xpm

WE ./Assets/so_longo.xpm

C  0    , 0, 0 
EA ./Assets/so_longo.xpm

1111111111111
10000100000011111111
10000100000011111111
1000010000001
1000000100001
11110S0011111
1000000000001
1000010000001
1000010000001
1000010000001
111111111111